4 13 31
###############################
#p *** * s   *   4** *  1 *  s#
#*# #*#*#1# #*#*#*# #*#*#w#*# #
#* *    * **   ** * **   *b  *#
#*# #*# #*#s# #b#*# # # # # # #
#     5*s*g s *   *  g*   ****#
#f#*#*# #b#*#*# # #b#*#*#g#b# #
# ** **x 1 *fs***g*  *d f*    #
#*#*#b#*# #*#*#*#*#*#*# #*# # #
# ** * *  s**  db*  f     * s #
#*# #s# # #*# # #*#*#*#*#*# #*#
#**b*  ****  *3g  *  ****3g** #
###############################
