3 13 31
###############################
#p* s** *  * * b * 1* * **** *#
# # #*#s#*#*#*#*# # # # #*#*#*#
# * **** * * * *b* * ****  3 *#
# # #x#*#*#2#*#*# #*#*#*#*# # #
# 2* * ***** **  *  **s * ****#
#*#*# #*# # # # #*#*# #*# # # #
#** *   ** 1*  **     *  ***1 #
# #s# # # #*#*# #*#*#*# # # # #
#* **** *** ** **f* ** * * ***#
# #*# #*#*# # # # # #*#*#*#*# #
#**      *  ** *** *1****   * #
###############################
