2 13 31
###############################
#p  *s*      1b* ***** b *  f #
# #  *#f*  f* # #*# # #3# #d#*#
#       **  *  5**** *  **  f*#
# #  *# # #*#*#b# # #x# # # # #
#g  wb 4d* ** **g  **  **s * *#
# #*# #*#     #b#*# # # # # #s#
#  ** w * f f* * *** * *b *b *#
#*# #b# #b        #*#*#*#*# #*#
# *   * **  *** w ** 1   ****b#
#*# # # # #*# #*#b# # # # # # #
#  * *  *  **** *s*  ** f* ***#
###############################
