5 13 31
###############################
#p    **f f* **b   *  3* ***d*#
#w# # #*# #b#*#f#*#s# # # # # #
#  *   4** *2* *2  b*w ****  g#
# # # # #b# # #*# # #*# # #*#*#
# *  **wd****2*  *   **x** d*s#
#*# # # #f#2#w# #*#*# #*# # #*#
#  *1 *** *f***g*    4* *f  s*#
#*# #*#*#*# #*#*# #*#*#g# # # #
#* * * *** **  **  ***b  ** g*#
#*#*#*#*# #*#*# # # # #b# # # #
#f  * *  ***fs d***  * *  * **#
###############################
